000000000000000000000000000000000000000000000000000000000000000000000000000000000000000000000000000
111111101111111111111111111111000011111111111111111111111111111111111111111111111111111111111111111
111111101111111111111111111111110011111111111111111111111111111111111111111115111111111111111111111
111111101111111111111111100011111011111111111111111111111111111111111111111100011111121111111111111
111111101111160000111001111111111011112111111111111111111111111111111111111111111111000011111111111
111111111110001111111001111111111111110011111111111111111111111111611100011111111611111111111111111
111111111111111111111001111000111110010011100000000011111111111110001111111111000011111111111111111
111111000111111111111001111111100111110011111111111111111111000011111111111111111111111111111111111
111113333333311114444001111333311144440033333331111133300044411111111111444444111111111111111111111
000000000000000000000000000000000000000000000000000000000000000000000000000000000000000000000000000
