00000000000000000000
01111111111111111110
01111161111161111110
01111111111111111110
01171111111111111110
01777000000000000000
00071111111111111110
00111111111111111910
01101111811111111110
01111111111111111110
01111111117111181110
01111811177711101110
00111111007011111110
01111111111111111115
01111111111111111110
01111110000111111110
01111001111111111110
11111111111111111110
00000000000000100000
00000000000000000000
