0000000000000000000000000000000000000000000000000000000000000000000000000000000000000000000000000000
1111111111111111111111111111111111111111111111111111111111111111111111111110000000000000000000000000
1111111111111111111111111111111111111111111111111111111111111111111111111110000000000000000000000000
1111111111111111111111111111111111111111111111111111111111111111111111111110000000000000000000000000
1111111111111111111111111161111111111111111111111111111111111111111111111110000000000000000000000000
1111111111111111111111110000000000000011111111112111110001011111111110000000000000000000000000000000
1111111111111111000000111111111111111111111111000000111111011111111111111110000000000000000000000000
1111111100000011111111111111111111111110000111111111111111011111111111111110000000000000000000000000
1111111111111111111111113333333333333311111111111444444111011114444444111115000000000000000000000000
0000000000000000000000000000000000000000000000000000000000000000000000000000000000000000000000000000