000000000000000000000000000000000000000000000000000000000000000000000000000000000000000000000000000
111111101111111001011111111010000111111111000000111111101111111110111111111111111111111111111111111
111111101111111101011111111011110011111111111111111211101111111110111611115111111111111111111111111
111111101111116111011111110001111101111100111111110001101111110011111000111111000111111211111111111
111111101111100001111001111111111011112111111100111111101111001100011111111111111111110000111111111
111111111111011111111001111111111111110011113334444411111111111111161110001111111161111111111111111
111111111100111110011001110000111110010011100000000011000043111111110001111111111000011111111111111
111111000111111111111001111111100111110011111111111111111111000011111111111111111111111111111111111
111113333333311114444001111333311144440033333331111133300044411111111111444444111111111111111111111
000000000000000000000000000000000000000000000000000000000000000000000000000000000000000000000000000
